########################################
#......................................#
#......................................#
#......................................#
#......................................#
#......................................#
#......................................#
#......................................#
#......................................#
#......................................#
#......................................#
#......................................#
#......................................#
#......................................#
#......................................#
#P....................................P#
##....................................##
##....................................##
##....................................##
##....................................##
##....................................##
##....................................##
##....................................##
##....................................##
##....................................##
##....................................##
##....................................##
##....................................##
##....................................##
########################################