########################################
#......................................#
#......................................#
#......................................#
#......................................#
#......................................#
#......................................#
#......................................#
#......................................#
#......................................#
#......................................#
#......................................#
#......................................#
#......................................#
#......................................#
#.....................................P#
#.....................................##
#.....................................##
#.....................................##
#.....................................##
#.....................................##
#.....................................##
#.....................................##
#.....................................##
#.....................................##
#.....................................##
#.....................................##
#.....................................##
#.P...................................##
########################################